waaaah
++++:       >       >  +:+:+:+:+:+:+:::::
====+      >^===    """=================
    +:-):(:^=   =                       !
    =========    =                      #
                  = !             .+.,:-<
                   =###           ======"
                   waaaah